1111111111111111
1000000000C00111
101110001C0000E1
1011000C11110111
1C11110001110101
1111110001111101
11100000000000P1
1111111111111111
